............................................................
............................................................
............................................................
............................................................
............................................................
............................................................
............................................................
............................................................
............................................................
............................................................
BBBBBBBBBBBB.......BBBBBBBBBBBBB.......BBBBBBBBBBBBB........
SRRRRRRRRRRB.......BRRRRRRRRRRRB.......BRRRRRRRRRRRB........
BBBBBBBBBBRB.......BRB.......BRB.......BRB.......BRB........
.........BRB.......BRB.......BRB.......BRB.......BRB........
.........BRB.......BRB.......BRB.......BRB.......BRB........
.........BRB.......BRB.......BRB.......BRB.......BRB........
.........BRB.......BRB.......BRB.......BRB.......BRB........
.........BRB.......BRB.......BRB.......BRB.......BRB........
.........BRB.......BRB.......BRB.......BRB.......BRB........
.........BRB.......BRB.......BRB.......BRB.......BRB........
.........BRB.......BRB.......BRB.......BRB.......BRB........
.........BRB.......BRB.......BRB.......BRB.......BRB........
.........BRB.......BRB.......BRB.......BRB.......BRB........
.........BRB.......BRB.......BRB.......BRB.......BRB........
.........BRB.......BRB.......BRB.......BRB.......BRB........
.........BRB.......BRB.......BRB.......BRB.......BRB........
.........BRB.......BRB.......BRB.......BRB.......BRB........
.........BRB.......BRB.......BRB.......BRB.......BRBBBBBBBBB
.........BRRRRRRRRRRRB.......BRRRRRRRRRRRB.......BRRRRRRRRRF
.........BBBBBBBBBBBBB.......BBBBBBBBBBBBB.......BBBBBBBBBBB
............................................................
............................................................
............................................................
............................................................
............................................................
............................................................
............................................................
............................................................
............................................................
............................................................
............................................................
............................................................
............................................................
............................................................
............................................................
............................................................
............................................................
............................................................
............................................................
............................................................