............................................................
............................................................
............................................................
............................................................
............................................................
............................................................
............................................................
.........RRRRRRRRRRRR.......................................
.........RRR.......RR.......................................
.........RRR.......RR.......................................
RRRRRRRRRRRR.......RRRRRRRRRRRRR.......RRRRRRRRRRRRR........
SRRRRRRRRRRR.......RRRRRRRRRRRRRRRRRRRRRRRRRRRRRRRRRRRRRRRRF
RRRRRRRRRRRR.......RRRRRRRRRRRRR.......RRR.......RRR........
.........RRR.......RRR.......RRR.......RRR.......RRR........
.........RRR.......RRR.......RRR.......RRR.......RRR........
.........RRRRRRRRRRRRR.......RRR.......RRR.......RRR........
.........RRR.......RRR.......RRR.......RRR.......RRR........
.........RRR.......RRR.......RRR.......RRR.......RRR........
.........RRR.......RRR.......RRR.......RRR.......RRR........
.........RRR.......RRR.......RRR.......RRR.......RRR........
.........RRR.......RRR.......RRR.......RRR.......RRR........
.........RRR.......RRR.......RRR.......RRR.......RRR........
.........RRR.......RRR.......RRR.......RRR.......RRR........
.........RRR.......RRR.......RRR.......RRR.......RRR........
.........RRR.......RRR.......RRR.......RRR.......RRR........
.........RRR.......RRR.......RRR.......RRR.......RRR........
.........RRR.......RRR.......RRR.......RRR.......RRR........
.........RRRRRRRRRRRRR.......RRRRRRRRRRRRR.......RRRRRRRRRRR
.........RRRRRRRRRRRRR.......RRRRRRRRRRRRR.......RRRRRRRRRRR
.........RRRRRRRRRRRRR.......RRRRRRRRRRRRR.......RRRRRRRRRRR
............................................................
............................................................
............................................................
............................................................
............................................................
............................................................
............................................................
............................................................
............................................................
............................................................
............................................................
............................................................
............................................................
............................................................
............................................................
............................................................
............................................................
............................................................
............................................................
............................................................