............................................................
............................................................
............................................................
............................................................
............................................................
............................................................
............................................................
............................................................
............................................................
............................................................
RRRRRRRRRRRR.......RRRRRRRRRRRRR.......RRRRRRRRRRRRR........
SRRRRRRRRRRR.......RRRRRRRRRRRRR.......RRRRRRRRRRRRR........
RRRRRRRRRRRR.......RRRRRRRRRRRRR.......RRR.......RRR........
.........RRR.......RRR.......RRR.......RRR.......RRR........
.........RRR.......RRR.......RRR.......RRR.......RRR........
.........RRRRRRRRRRRRR.......RRR.......RRR.......RRR........
.........RRR.......RRR.......RRR.......RRR.......RRR........
.........RRR.......RRR.......RRR.......RRR.......RRR........
.........RRR.......RRR.......RRR.......RRR.......RRR........
.........RRR.......RRR.......RRR.......RRR.......RRR........
.........RRR.......RRR.......RRR.......RRR.......RRR........
.........RRR.......RRR.......RRR.......RRR.......RRR........
.........RRR.......RRR.......RRR.......RRR.......RRR........
.........RRR.......RRR.......RRR.......RRR.......RRR........
.........RRR.......RRR.......RRR.......RRR.......RRR........
.........RRR.......RRR.......RRR.......RRR.......RRR........
.........RRR.......RRR.......RRR.......RRR.......RRR........
.........RRRRRRRRRRRRR.......RRRRRRRRRRRRR.......RRRRRRRRRRR
.........RRRRRRRRRRRRR.......RRRRRRRRRRRRR.......RRRRRRRRRRF
.........RRRRRRRRRRRRR.......RRRRRRRRRRRRR.......RRRRRRRRRRR
............................................................
............................................................
............................................................
............................................................
............................................................
............................................................
............................................................
............................................................
............................................................
............................................................
............................................................
............................................................
............................................................
............................................................
............................................................
............................................................
............................................................
............................................................
............................................................
............................................................