..............................
..............................
..............................
..............................
..............................
..............................
..............................
SRRRRR....RRRRRR....RRRRRR....
.....R....R....R....R....R....
.....R....R....R....R....R....
.....R....R....R....R....R....
.....R....R....R....R....R....
.....R....R....R....R....R....
.....R....R....R....R....R....
.....R....R....R....R....R....
.....R....R....R....R....R....
.....R....R....R....R....R....
.....R....R....R....R....R....
.....RRRRRR....RRRRRR....RRRRF
..............................
..............................
..............................
..............................
..............................
..............................